C 234, 181, 67
NO ./ressources/stonewall.xpm
SO ./ressources/Textures/Wood.xpm
EA ./ressources/Textures/WoodBanner.xpm

WE ./ressources/duck.xpm
F 47, 54, 64

   111111111111111111111111111111111111
  1100001000000100000000000000000000001
111100001000000000000000001111100000001
111100000000111110000000000000100000001
100000000001000000000000000000100000001
100000000000011100011111111111100000001
10E0111100000001000000000000000000000001
10000011111000011101111111111000000000001
1001111111000001 101       100001110000001
1000000000000001 101      100001   10000001
1000000000000001 101     100001     10000001
1000000111100001 101     10001       10000001
1000000111100001 101     10001        10000001
1110000000000001 101  11110001         10000001
1110000000000001 101  10000011111111111100000001
11110001111111111101  10000010000000000000000001
   10000000000000001  1000001000000000000000001
   11111111111111111  111111 11111111111111111