NO ./ressources/wojak.xpm
SO ./ressources/stonewall.xpm
EA ./ressources/wall.xpm
WE ./ressources/wojak.xpm

F 12,255,255
C 0,0,255

1111
10001
10N01
10001
11111